############################
#..........................#
#.####.#####.##.#####.####.#
#.####.#####.##.#####.####.#
#..........................#
#.####.##.########.##.####.#
#......##....##....##......#
######.#####.##.#####.######
######.#####.##.#####.######
######.##..........##.######
######.##.########.##.######
######.##.########.##.######
..........................##
######.##.########.##.######
######.##.########.##.######
######.##..........##.######
######.##.########.##.######
#..........................#
#.####.#####.##.#####.####.#
#..........................#
###.##.##.########.##.##.###
#......##....##....##......#
#..........................#
#..........................#
############################
